//MAP CONVERTED BY dmm2tgm.py THIS HEADER COMMENT PREVENTS RECONVERSION, DO NOT REMOVE
"a" = (
/turf/closed/indestructible/wood,
/area/virtual_domain/safehouse)
"b" = (
/turf/open/floor/wood,
/area/virtual_domain/safehouse)
"c" = (
/obj/structure/table/wood/fancy/black,
/obj/item/knife/bloodletter,
/obj/item/knife/bloodletter{
	pixel_x = -6
	},
/obj/item/clothing/suit/hooded/cloak/goliath,
/obj/item/clothing/mask/gas/driscoll,
/obj/item/clothing/shoes/cowboy/black,
/obj/item/climbing_hook,
/obj/item/flashlight/flare/torch,
/obj/item/storage/box/syndie_kit/throwing_weapons,
/turf/open/floor/wood,
/area/virtual_domain/safehouse)
"h" = (
/obj/structure/chair/stool/directional/west{
	pixel_x = -11
	},
/turf/open/floor/wood,
/area/virtual_domain/safehouse)
"k" = (
/obj/structure/table/wood/fancy,
/obj/item/clothing/head/helmet/knight/red,
/obj/item/clothing/suit/armor/riot/knight/red,
/obj/item/fireaxe/boneaxe,
/obj/item/clothing/shoes/plate/red,
/obj/item/climbing_hook,
/obj/item/flashlight/flare/torch,
/turf/open/floor/wood,
/area/virtual_domain/safehouse)
"n" = (
/obj/structure/chair/stool/directional/north{
	pixel_y = 17
	},
/turf/open/floor/wood,
/area/virtual_domain/safehouse)
"r" = (
/obj/structure/table/wood,
/obj/item/flashlight/flare/candle{
	pixel_y = 15
	},
/obj/item/plate,
/obj/item/food/fried_chicken,
/obj/item/kitchen/fork{
	pixel_x = 8;
	pixel_y = 6
	},
/turf/open/floor/wood,
/area/virtual_domain/safehouse)
"s" = (
/obj/structure/table/wood/fancy/blue,
/obj/item/clothing/head/wizard,
/obj/item/gun/magic/wand/fireball,
/obj/item/clothing/suit/wizrobe,
/obj/item/clothing/shoes/sandal/magic,
/obj/item/climbing_hook,
/obj/item/flashlight/flare/torch,
/obj/item/gun/magic/staff/healing/unrestricted,
/obj/item/spellbook/bitrunner,
/turf/open/floor/wood,
/area/virtual_domain/safehouse)
"t" = (
/obj/effect/landmark/bitrunning/hololadder_spawn,
/turf/open/floor/wood/tile,
/area/virtual_domain/safehouse)
"x" = (
/obj/structure/chair/stool/directional/east{
	pixel_x = 12
	},
/turf/open/floor/wood,
/area/virtual_domain/safehouse)
"y" = (
/obj/structure/mineral_door/wood,
/obj/structure/fans/tiny,
/turf/open/floor/wood,
/area/virtual_domain/safehouse)
"B" = (
/obj/structure/table/wood,
/obj/structure/reagent_dispensers/beerkeg,
/turf/open/floor/wood,
/area/virtual_domain/safehouse)
"C" = (
/obj/structure/chair/stool{
	pixel_y = 3
	},
/turf/open/floor/wood,
/area/virtual_domain/safehouse)
"D" = (
/obj/effect/mob_spawn/ghost_role/human/bartender{
	prompt_name = "ye olde bartender";
	name = "tavernkeeper sleeper"
	},
/turf/open/floor/wood,
/area/virtual_domain/safehouse)
"G" = (
/obj/structure/chair/stool/directional,
/turf/open/floor/wood,
/area/virtual_domain/safehouse)
"I" = (
/obj/structure/table/wood,
/obj/item/reagent_containers/cup/glass/mug,
/turf/open/floor/wood,
/area/virtual_domain/safehouse)
"J" = (
/obj/structure/table/wood,
/obj/item/plate,
/obj/item/flashlight/flare/candle{
	pixel_y = 15
	},
/obj/item/food/fried_chicken,
/obj/item/kitchen/fork{
	pixel_x = 8;
	pixel_y = 6
	},
/turf/open/floor/wood,
/area/virtual_domain/safehouse)
"Q" = (
/obj/structure/table/wood,
/obj/item/reagent_containers/cup/glass/bottle/wine/unlabeled{
	pixel_x = 12;
	pixel_y = 19
	},
/obj/item/reagent_containers/cup/glass/bottle/wine/unlabeled{
	pixel_x = -8;
	pixel_y = 19
	},
/obj/item/reagent_containers/cup/glass/bottle/moonshine{
	pixel_x = 2;
	pixel_y = 2
	},
/obj/item/reagent_containers/cup/glass/bottle/wine/unlabeled{
	pixel_y = 19;
	pixel_x = 5
	},
/obj/item/reagent_containers/cup/glass/bottle/wine/unlabeled{
	pixel_y = 19;
	pixel_x = -1
	},
/turf/open/floor/wood,
/area/virtual_domain/safehouse)
"S" = (
/obj/effect/landmark/bitrunning/cache_goal_turf,
/obj/effect/turf_decal/loading_area{
	dir = 1
	},
/obj/structure/railing{
	dir = 8
	},
/obj/machinery/light/small/directional/north,
/obj/structure/railing{
	dir = 4
	},
/turf/open/floor/bitrunning_transport,
/area/virtual_domain/safehouse)
"U" = (
/obj/structure/chair/stool/bar/directional/east{
	pixel_x = 14;
	pixel_y = 12
	},
/obj/structure/chair/stool/bar/directional/east{
	pixel_x = 14
	},
/obj/structure/chair/stool/bar/directional/east{
	pixel_x = 14;
	pixel_y = -12
	},
/turf/open/floor/wood,
/area/virtual_domain/safehouse)
"W" = (
/obj/structure/chair/stool/bar/directional/east{
	pixel_x = 9
	},
/turf/open/floor/wood,
/area/virtual_domain/safehouse)
"Y" = (
/obj/effect/landmark/bitrunning/cache_goal_turf,
/obj/effect/turf_decal/loading_area{
	dir = 1
	},
/obj/structure/railing{
	dir = 4
	},
/obj/machinery/light/small/directional/north,
/turf/open/floor/bitrunning_transport,
/area/virtual_domain/safehouse)

(1,1,1) = {"
a
a
a
a
a
a
"}
(2,1,1) = {"
a
Y
b
b
b
a
"}
(3,1,1) = {"
a
t
b
k
b
a
"}
(4,1,1) = {"
a
t
b
s
b
y
"}
(5,1,1) = {"
a
t
b
c
b
a
"}
(6,1,1) = {"
a
S
b
b
b
a
"}
(7,1,1) = {"
a
b
x
b
b
a
"}
(8,1,1) = {"
a
C
r
n
b
a
"}
(9,1,1) = {"
a
b
h
x
b
a
"}
(10,1,1) = {"
a
b
G
J
n
a
"}
(11,1,1) = {"
a
U
W
U
W
a
"}
(12,1,1) = {"
a
I
I
I
I
a
"}
(13,1,1) = {"
a
D
b
b
b
a
"}
(14,1,1) = {"
a
B
B
Q
B
a
"}
(15,1,1) = {"
a
a
a
a
a
a
"}
